11111111111111111111111111
15111100010001000000000011
10410001000100000111000011
10117101111111110001111011
10000100000000011101001011
11111101010100000141001011
10000001010111100111001011
10111101010000100000001011
10014101011110111101101011
11000101000000000000111011
11111101111111111100001011
14000100000000000101011011
11110101111111110101010011
10010101001000010101011011
10010101101010110101001011
10000000001010010100011011
10011111111010000111010011
10001000141011110161011011
10000010001010000001001411
11111111111311111111111111
11111111111111111111111111
11111111111111111111111111