1111111111
1000050001
1000000001
1000000001
1000000001
1000030001
1111111111